11111111111111111111
10000000000000400061
10120000000000000001
10100001010101000001
10000000000001555551
10100100101011000001
10108108000000000001
17000000030000000001
10000000000000000001
11111111111100000111