11111111111111100111
12010000100800000061
11000000000000000001
11083000000111000001
11000000000100000001
11000000000100000001
11111100000100000001
10000000000100000001
17000000000000000041
11111111111111111111