11111111111111111111
10000000000000000061
10281115555555555551
10001000101111111101
10111080100100000101
10100030100004000000
10100000100000000000
10100000111111110000
10000000000000000001
11111111111111110001