28000000000000000006
08300000000000000001
11111111111111100001
10000000000000101001
10000000000000101001
10000000000000101001
10000011111111110001
17000000000000000800
10000000000000000000
10040000000000000000